--|---------|---------|---------|
01|                              
02|╭tree test_dir/ -L 4─────────╮
03|│ 󰉋 dir_a                    │
04|│   󰉋 dir_c                  │
05|│     󰌝 index.html           │
06|│     󰌞 index.js             │
07|│    init.lua               │
08|│   󰛦 mod.ts                 │
09|│ 󰉋 dir_b                    │
10|│    .env                   │
11|│   󱁤 Makefile               │
12|╰────────────────────────────╯
13|~                             
14|~                             
15|~                             
16|~                             
17|~                             
18|~                             
19|[No Name]   0,0-1          All
20|               1,1        All 

--|---------|---------|---------|
01|000000000000000000000000000000
02|122222222222222222221111111111
03|133333333333333333333333333331
04|111111111111111111111111111111
05|111111111111111111111111111111
06|111111111111111111111111111111
07|111111111111111111111111111111
08|111111111111111111111111111111
09|111111111111111111111111111111
10|111111111111111111111111111111
11|111111111111111111111111111111
12|111111111111111111111111111111
13|444444444444444444444444444444
14|444444444444444444444444444444
15|444444444444444444444444444444
16|444444444444444444444444444444
17|444444444444444444444444444444
18|444444444444444444444444444444
19|555555555555555555555555555555
20|666666666666666666666666666666
