--|---------|---------|---------|
01|                              
02|╭tree test_dir/ -L 2────────╮ 
03|│󰉋 .                        │ 
04|│  󰉋 dir_a                  │ 
05|│    󰉋 dir_c                │ 
06|│     init.lua             │ 
07|│    󰛦 mod.ts               │ 
08|│  󰉋 dir_b                  │ 
09|│     .env                 │ 
10|│    󱁤 Makefile             │ 
11|╰───────────────────────────╯ 
12|~                             
13|~                             
14|~                             
15|~                             
16|~                             
17|~                             
18|~                             
19|~                             
20|~                             
21|~                             
22|~                             
23|~                             
24|~                             
25|~                             
26|~                             
27|~                             
28|~                             
29|[No Name]   0,0-1          All
30|               1,1        All 

--|---------|---------|---------|
01|000000000000000000000000000000
02|122222222222222222221111111113
03|144444444444444444444444444413
04|111111111111111111111111111113
05|111111111111111111111111111113
06|111111111111111111111111111113
07|111111111111111111111111111113
08|111111111111111111111111111113
09|111111111111111111111111111113
10|111111111111111111111111111113
11|111111111111111111111111111113
12|333333333333333333333333333333
13|333333333333333333333333333333
14|333333333333333333333333333333
15|333333333333333333333333333333
16|333333333333333333333333333333
17|333333333333333333333333333333
18|333333333333333333333333333333
19|333333333333333333333333333333
20|333333333333333333333333333333
21|333333333333333333333333333333
22|333333333333333333333333333333
23|333333333333333333333333333333
24|333333333333333333333333333333
25|333333333333333333333333333333
26|333333333333333333333333333333
27|333333333333333333333333333333
28|333333333333333333333333333333
29|555555555555555555555555555555
30|666666666666666666666666666666
