--|---------|---------|---------|
01|                              
02|╭tree test_dir/ -L 3─────────╮
03|│󰉋 .                         │
04|│  󰉋 dir_a                   │
05|│    󰉋 dir_c                 │
06|│      󰌝 index.html          │
07|│      󰌞 index.js            │
08|│     init.lua              │
09|│    󰛦 mod.ts                │
10|│  󰉋 dir_b                   │
11|│     .env                  │
12|│    󱁤 Makefile              │
13|╰────────────────────────────╯
14|~                             
15|~                             
16|~                             
17|~                             
18|~                             
19|~                             
20|~                             
21|~                             
22|~                             
23|~                             
24|~                             
25|~                             
26|~                             
27|~                             
28|~                             
29|[No Name]   0,0-1          All
30|               1,1        All 

--|---------|---------|---------|
01|000000000000000000000000000000
02|122222222222222222221111111111
03|133333333333333333333333333331
04|111111111111111111111111111111
05|111111111111111111111111111111
06|111111111111111111111111111111
07|111111111111111111111111111111
08|111111111111111111111111111111
09|111111111111111111111111111111
10|111111111111111111111111111111
11|111111111111111111111111111111
12|111111111111111111111111111111
13|111111111111111111111111111111
14|444444444444444444444444444444
15|444444444444444444444444444444
16|444444444444444444444444444444
17|444444444444444444444444444444
18|444444444444444444444444444444
19|444444444444444444444444444444
20|444444444444444444444444444444
21|444444444444444444444444444444
22|444444444444444444444444444444
23|444444444444444444444444444444
24|444444444444444444444444444444
25|444444444444444444444444444444
26|444444444444444444444444444444
27|444444444444444444444444444444
28|444444444444444444444444444444
29|555555555555555555555555555555
30|666666666666666666666666666666
