--|---------|---------|---------|
01|                              
02|╭tree test_dir/ -L 2──────╮   
03|│󰉋 dir_a                  │   
04|│  󰉋 dir_c                │   
05|│   init.lua             │   
06|│  󰛦 mod.ts               │   
07|│󰉋 dir_b                  │   
08|│   .env                 │   
09|│  󱁤 Makefile             │   
10|╰─────────────────────────╯   
11|~                             
12|~                             
13|~                             
14|~                             
15|~                             
16|~                             
17|~                             
18|~                             
19|[No Name]   0,0-1          All
20|               1,1        All 

--|---------|---------|---------|
01|000000000000000000000000000000
02|122222222222222222221111111333
03|144444444444444444444444441333
04|111111111111111111111111111333
05|111111111111111111111111111333
06|111111111111111111111111111333
07|111111111111111111111111111333
08|111111111111111111111111111333
09|111111111111111111111111111333
10|111111111111111111111111111333
11|333333333333333333333333333333
12|333333333333333333333333333333
13|333333333333333333333333333333
14|333333333333333333333333333333
15|333333333333333333333333333333
16|333333333333333333333333333333
17|333333333333333333333333333333
18|333333333333333333333333333333
19|555555555555555555555555555555
20|666666666666666666666666666666
